2222222222222222
2311111221111132
2122221221222212
2121111111111212
2111222222221112
2122211111122212
2111212112121112
2121112112111212
2121112112111212
2111212112121112
2122211111122212
2111222222221112
2121111111111212
2122221221222212
2311111221111132
2222222222222222
