22222222222222222222
23111111111111111132
21112211112222222112
21211111111112111112
21112111112211121112
21222111111121121112
21112121121211121112
21211121121112121112
21211121121112111112
21112121121211111112
21222111111211111112
21112211221111111112
21111111221112221112
21221111221112221112
21111111221111111112
21111111221111111112
21122211111112221112
21122211111112221112
23111111111111111132
22222222222222222222
